NO ./textures/brick.xpm
SO ./textures/blue.xpm
WE ./textures/wood.xpm
EA ./textures/grey.xpm

F 224,172,105
C     205,249,     255

111111 11111
1         11
1     1 0001
100000000011
10S000000001
111111111111
11         1
111111111111