NO assets/maps/test1.cub
F 220,100,0
C 225,30,0
SO assets/maps/test1.cub
WE assets/maps/test1.cub
EA assets/maps/test1.cub

11111
1S001
11111