NO ./assets/pngs/snow.png
SO ./assets/pngs/desert.png
WE ./assets/pngs/west.png
EA ./assets/pngs/east.png

F 92, 62, 36
C 71, 76, 230

         111111111  111111111111111111
         100000001  10000000000000N01
         10110000111100000001111111111
11111111110000000000000000011111
10000000111100010000000001001
100000001  100110101110000001
10000000111110000001 10100001
11111111111111111111 11111111