NO ./assets/pngs/snow.png
SO ./assets/pngs/desert.png
WE ./assets/pngs/west.png
EA ./assets/pngs/east.png

F 92, 62, 36
C 71, 76, 230

111111111111111111111
1W0000000000000000001
111111111111111111111
